btn-get-started-text=Get started
btn-reset-text=Start over
btn-restart-text=Register or reset another account
btn-next-text=Next
btn-login-text=Login

error-title=Oops
error-title-missing-data=Missing data
error-title-invalid-data=Invalid data

verification-method-choice-header=Validate your account
verification-method-choice-sub-header=
verification-method-choice-footer=

identify-header=Enter one of the following numbers to get started:
identify-footer=

result-header=We have successfully verified your identity. You can now logon to online services using the credentials provided below.
result-footer=

call-cic-dfrdb=
call-cic-pss=
call-cic-css=
call-cic-msbs=
call-cic-adfc=
call-cic=Sorry, we can't verify your identity with the information provided. Please check your details and start over.

no-membership-number-provided-adfc=Please provide your member number to register for Pensioner Services Online.
no-membership-number-provided=Please provide your member number to register for Member Services Online or Pensioner Services Online.

invalid-nembership-number-provided-css=Please provide a valid member number to continue with CSS
invalid-nembership-number-provided-pss=Please provide a valid member number to continue with PSS
invalid-nembership-number-provided-dfrdb=Please provide a valid member number to continue with DFRDB
invalid-nembership-number-provided-msbs=Please provide a valid member number to continue with MSBS
invalid-nembership-number-provided-adfc=Please provide a valid member number to continue with ADFC
invalid-nembership-number-provided=Please provide a valid member number to continue

hygine-questions-title=Questions about yourself
hygine-questions-footer=These questions help us verify your identity, if you don't know an answer you can skip it

hygine-first-name-question=What is your first name?
hygine-first-name-placeholder=John
hygine-first-name-help-text=Provide your first name
hygine-first-name-icon=fa-user

hygine-surname-question=What is your surname?
hygine-surname-placeholder=Smith
hygine-surname-help-text=Provide your surname
hygine-surname-icon=fa-user

hygine-age-question=What is your age?
hygine-age-placeholder=21
hygine-age-help-text=Provide your age
hygine-age-icon=fa-calendar

hygine-tfn-question=What is your tax file number?
hygine-tfn-placeholder=87654321
hygine-tfn-help-text=Provide your tax file number. This should be a 8 or 9 digit long numerical value.
hygine-tfn-icon=fa-hashtag

token-sms-title=We have sent a verification code to your mobile phone. Please enter it below:
token-sms-footer=You should have received it immediately, however in rare cases it can take up to 5 minutes. If you didn't receive one, click start over and choose an alternative verification method.
token-sms-question=
token-sms-placeholder=012345
token-sms-help-text=
token-sms-icon=fa-mobile

token-email-title=We have sent a verification code to your email address. Please enter it below:
token-email-footer=You should have received it immediately, however in rare cases it can take up to 5 minutes. If you didn't receive one, click start over and choose an alternative verification method.
token-email-question=
token-email-placeholder=012345
token-email-help-text=
token-email-icon=fa-envelope-o

membership-questions-title=Questions about your membership with
membership-questions-footer=These questions help us verify your identity, if you don't know an answer you can skip it

membership-join-date-question=When did you join this scheme?
membership-join-date-help-text=Provide the date you entered this scheme
membership-join-date-placeholder=21/6/1985
membership-join-date-icon=fa-calendar

membership-exit-date-question=When did you exit this scheme?
membership-exit-date-help-text=Provide the date you exited this scheme
membership-exit-date-placeholder=21/6/1985
membership-exit-date-icon=fa-calendar

membership-status-question=What is your membership status?
membership-status-help-text=Provide your scheme status
membership-status-placeholder=Contributor
membership-status-icon=fa-question

contact-details-questions-title=Tell us about how we communicate with you
contact-details-questions-footer=These questions help us verify your identity, if you don't know an answer you can skip it

contact-details-phone-number-question=What is your phone number?
contact-details-phone-number-help-text=Provide your phone number
contact-details-phone-number-placeholder=22222222
contact-details-phone-number-icon=fa-phone

contact-details-post-code-question=What is your postcode?
contact-details-post-code-help-text=Provide the postcode for your current address
contact-details-post-code-placeholder=2617
contact-details-post-code-icon=fa-home

contact-details-suburb-question=What is your city / suburb?
contact-details-suburb-help-text=Provide the city / suburb for your current address
contact-details-suburb-placeholder=Belconnen
contact-details-suburb-icon=fa-home

contact-details-state-question=What is your state?
contact-details-state-text=Provide the state for your current address
contact-details-state-placeholder=ACT
contact-details-state-icon=fa-home

no-verification-method-chosen=Please choose a verification method

question-set-heading-description=Answer these questions about yourself to help us verify your identity. Don't worry if you don't know an answer as you can skip to the next question.
question-set-heading-contact-cic=